----------------------
|A                  B|
|                    |
|                    |
|                    |
|                    |
|          &         |
|                    |
|                    |
|                    |
|C                  D|
----------------------